Calm before the storm
None
...............
......|........
...............
......D........
......E........
HOPE..E.......*
......P........
...............
...BREATH......
...............
...............