End and rebuild
open,end
...............
.....|.........
.....S.........
.....A.........
....|D|DESPAIR.
HOPE.N........*
.....E..D......
....HS.........
....US.........
....R|.........
....T..........