Gridlock
...............
......|........
...............
......D........
......O........
HOPE..U.......*
......B....S...
......T....T...
...........I...
|..LINGERS.L...
...........L...