Theseus
.......|W......
W......|I......
A......|S......
SELP...........
...|...|...L...
HOPE...|...A..*
|K.N...|.W.T...
CA.D...........
.YL....|.RA|...
..A....|.TI....
..Y....|.HN....