Breakaway
...............
.........EVCF..
.........AOAO..
.........RIRC..
.........NCEU..
HOPELESS......*
...............
...............
...............
...............
...............