Theseus
help,cope,prove
.......|W..|...
.......|I......
P......|S......
UELP...........
S..|...|..|R...
HOPE...|...O..*
|K.N...||W.V...
CA.D...........
.YL....|.RA|...
..A....|.TI....
..Y....|.HN....