Theseus
help,cope,prize
.......|W..|...
.......|I......
P......|S......
UELP........|..
S..|...|..|R...
HOPE...|...I..*
|K.N...||D.Z...
CA.D........|..
.YL....|.UA|...
..A....|.BI....
..Y|...|.TN....