End and rebuild
.....S.........
.....A.........
.....D.........
.....N.........
....|E.DESPAIR.
HOPE.S........*
.....S..D......
....H..........
....U..........
....R|.........
....T..........