Split the middle
...............
........W......
........O......
........R......
........T......
HOPE....H.....*
........L......
........E......
........S......
........S......
...............