Breakaway
dwell,voice,cares,focus
...............
.........DVCF..
.........WOAO..
.........EIRC..
.........LCEU..
HOPELESS......*
...............
...............
...............
...............
...............