Roadblock
...............
...............
...............
......D........
......O........
HOPE..U.......*
......B........
......T........
...............
...............
...............