From the ashes
.....S.........
.....A.........
.....D.........
.....N.........
....|E.DESPAIR.
HOPE.S........*
.....S..D......
....H...U......
....U...R......
....R|..E......
....T..........