Hop over
dread,hop
...............
..........|....
...............
.....D....F....
.....R....E....
HOPE......A...*
.....A....R....
.....D.........
..........|....
...............
...............