Thanks
thanks,for,playing
...............
....THANKS.....
...............
..FOR.PLAYING..
...............
.HOPE.FALTERS.*
...............
...MADE.FOR....
...............
..LD54.COMPO...
...............