Inky
ask
...............
...............
...............
...............
...............
HOPE..A.......*
......S........
.DARK..|.NIGHT.
...............
...............
...............